TILEMAP
32 26 							-- Size of tile map in tiles
16 16 							-- Tile size & block size
images/TheGoonies-MapTiles2-2.png 	-- Tilesheet
16 16								-- Number of tiles in tilesheet
OoOoOoOoOoOoOoOoOoOoOoOoOoOoOoOoOoOoOoOoOoOoOoOoOoOoOoOoOoOoOoOo
OoNcNdNkOoOoOoOoOoOoOoNiNdNhOoOoOoOoOoOoOoOoOoOoOoOoNgNaNbNeNbOo
OoNlNfNkOoOoOoOoOoOoOoNbNjNfOoOoOoOoOoOoOoOoOoOoOoOoNmOoNkNmOoOo
EdOoOoOoOoPoOoOoOoOoOoOoOoOoOoOoOoOoOoOoOoPoOoOoOoOoOoOoOoOoOoEc
EbOoOoOoOoBpOoOoOoOoOoOoOoOoOoOoOoOoOoOoOoBpOoOoOoOoOoOoOoOoOoEa
EdOoOoOoOoBpOoOoOoOoOoOoOoOoOoOoOoOoOoOoOoBpOoOoOoOoOoOoOoOoOoEc
EdOoOoOoOoBpOoOoOoOoOoOoOoOoOoOoOoOoOoOoOoBpOoOoOoOoOoOoOoOoOoEc
EdOoOoOoOoBpOoOoOoOoOoOoOoOoOoOoOoOoOoOoOoBpOoOoOoOoOoOoOoOoOoEc
EbOoOoOoOoBpOoOoOoOoOoOoOoOoOoOoOoOoOoOoOoBpOoOoOoOoOoOoOoOoOoEc
EdOoOoOoOoBpOoOoOoOoOoOoOoOoOoOoOoOoOoOoOoBpOoOoOoOoOoOoOoOoOoEa
EdOoOoOoOoBpOoOoOoOoOoAeAaAaAaAaAaAaAaAaAaAbAaAaAaAaAaAaAaAaAaAm
EdOoOoOoOoBpOoOoOoOoOoDgFhBoDhDeDfDhDgDeDfDhDgDcEgEhEgEhEgEhEgEh
EbOoOoOoOoBpOoOoOoOoOoOoOoBpOoOoOoOoOoOoOoOoOoEcEhEgEhEgEhEgEhEg
EdOoOoOoOoBpOoOoOoOoOoOoOoBpOoOoOoOoOoOoOoOoOoEaEgEhEgEhEgEhEgEh
EdOoOoOoOoBpOoOoOoOoOoOoOoBpOoOoOoOoOoOoOoOoOoEcEhEgEhEgEhEgEhEg
EdOoOoOoOoBpOoOoOoOoOoOoOoBpOoOoOoOoOoOoOoOoOoOoDfDhDgDeDfDhDgDc
EbOoOoOoOoBpOoOoOoOoOoOoOoBpOoOoOoOoOoOoOoOoOoOoOoOoOoOoOoOoOoEc
EdOoOoOoOoBpOoOoOoOoOoOoOoBpOoOoOoOoOoOoOoJfJgJhOoOoOoOoOoOoOoEa
EdOoOoOoOoBpOoOoOoOoOoOoOoBpOoOoOoOoOoOoOoMcMdMeOoOoOoOoOoOoOoEc
EdOoOoOoOoBpOoOoOoOoOoOoOoBpOoOoOoOoOoOoOoMfOoMbOoOoOoOoOoOoOoEc
EbOoOoOoOoBpOoOoOoOoOoAeAaAbAaAaAaAaAaAaAaBhAaBdAaAaAaAaAaAaAaAm
EdOoOoOoOoBpOoOoOoOoOoDgFhDgDhDeDfDgBoDeDfDgDhDeDfDhDgDeDfDhDgDc
EdNnNnNnNnPnNnNnNnNnNnNnNnNnNnNnNnNnPnNnNnNnNnNnNnNnNnNnNnNnNnEc
OdOdOdOdOdOdOdOdOdOdOdOdOdOdOdOdOdOdOdOdOdOdOdOdOdOcOeOfOfOfOdOd
OoOoOoOoOoOoOoOoOoOoOoOoOoOoOoOoOoOoOoOoOoOoOoOoOoOoOoNpNpNpOoOo
OoOoOoOoOoOoOoOoOoOoOoOoOoOoOoOoOoOoOoOoOoOoOoOoOoOoOoOoOoOoOoOo