TILEMAP
32 26 							-- Size of tile map in tiles
16 16 							-- Tile size & block size
images/TheGoonies-MapTiles2-2.png 	-- Tilesheet
16 16								-- Number of tiles in tilesheet
OoOoOoOoOoOoOoOoOoOoOoOoOoOoOoOoOoOoOoOoOoOoOoOoOoOoOoOoOoOoOoOo
OoNcNdNkOoOoOoOoOoOoOoNiNdNhOoOoOoOoOoOoOoOoOoOoOoOoNgNaNbNeNbOo
OoNlNfNkOoOoOoOoOoOoOoNbNjNfOoOoOoOoOoOoOoOoOoOoOoOoNmOoNkNmOoOo
DdDgDhDeDfDgDhDeDfDgDhDeDfDgDhDeDfDhDgDeDfDhDgDeDfDhDgDeDfDhDgDc
EdOoOoOoOoOoOoOoOoOoOoOoOoOoOoOoOoOoOoOoOoOoOoOoOoOoOoOoOoOoOoEc
EbOoOoOoOoOoOoOoOoOoOoOoOoOoOoOoOoOoOoOoOoOoOoOoOoOoOoOoOoOoOoEa
EdOoOoOoOoOoOoOoAeAaAaAaAaAaAaAaAaAaAaAaAaAaAaAfOoOoOoOoOoOoOoEc
EdOoOoOoOoOoOoOoDfDhBoDeDfDhDgDeDfDgDhDeDfDgDhDeOoOoOoOoOoOoOoEc
EbOoOoOoOoOoOoOoOoOoBpOoOoOoOoOoOoOoOoOoOoOoOoOoOoOoOoOoOoOoOoEa
EdOoOoJfJgJhOoOoOoOoBpOoOoOoOoOoOoOoOoOoOoOoOoOoJdJpJeOoOoOoOoEc
EdOoOoMcMdMeOoOoOoOoBpOoOoOoOoOoOoOoOoOoOoOoOoOoKdJoKeOoOoOoOoEc
EdOoOoMfOoMbOoOoOoOoBpOoOoOoOoOoOoOoOoOoOoOoOoOoJbPfJaOoOoOoOoEc
AnAaAaBhAaBdAaAaAaAaAbAfAcAdAdAdAdAdAdAcAeAaAaAaApAaAoAaAaAaAaAm
DdDgDhDeDfBoDhDeDfDgDhFdGeGdGdGdGdGdGdGeFeBoDgDeDfDhDgDeDfDhDgDc
EbOoOoOoOoBpOoOoOoOoOoOoOoOoOoOoOoOoOoOoOoBpOoOoOoOoOoOoOoOoOoEc
EdOoOoOoOoBpOoOoOoOoOoOoOoOoOoOoOoOoOoOoOoBpOoOoOoOoOoOoOoOoOoEc
EbOoOoOoOoBpOoOoOoOoOoOoOoOoOoOoOoOoOoOoOoBpOoOoOoOoOoOoOoOoOoEa
EdOoOoOoOoBpOoOoOoOoOoOoOoOoOoOoOoOoOoOoOoBpOoOoOoOoOoOoOoOoOoEc
EdOoOoOoOoBpOoOoOoOoOoOoOoOoOoOoOoOoOoOoOoBpOoOoOoOoOoOoOoOoOoEc
EdOoOoOoOoBpOoOoOoOoOoOoOoOoOoOoOoOoOoOoOoBpOoOoOoOoOoOoOoOoOoEc
EbOoOoOoOoBpOoOoOoOoOoOoOoOoOoOoOoOoOoOoOoBpOoOoOoOoOoOoOoOoOoEa
EdOoOoOoOoBpOoOoOoOoOoOoOoOoOoOoOoOoOoOoOoBpOoOoOoOoOoOoOoOoOoEc
EdNnNnNnNnPnNnNnNnNnNnNnNnNnNnNnNnNnNnNnNnPnNnNnNnNnNnNnNnNnNnEc
OdOdOdOdOdOdOdOdOdOdOdOdOdOdOdOdOdOdOdOdOdOdOdOdOdOcOeOfOfOfOdOd
OoOoOoOoOoOoOoOoOoOoOoOoOoOoOoOoOoOoOoOoOoOoOoOoOoOoOoNpNpNpOoOo
OoOoOoOoOoOoOoOoOoOoOoOoOoOoOoOoOoOoOoOoOoOoOoOoOoOoOoOoOoOoOoOo