TILEMAP
32 26 							-- Size of tile map in tiles
16 16 							-- Tile size & block size
images/TheGoonies-MapTiles2.png 	-- Tilesheet
16 16								-- Number of tiles in tilesheet
OoOoOoOoOoOoOoOoOoOoOoOoOoOoOoOoOoOoOoOoOoOoOoOoOoOoOoOoOoOoOoOo
OoNcNdNkOoOoOoOoOoOoOoNiNdNhOoOoOoOoOoOoOoOoOoOoOoOoNgNaNbNeNbOo
OoNlNfNkOoOoOoOoOoOoOoNbNjNfOoOoOoOoOoOoOoOoOoOoOoOoNmOoNkNmOoOo
EdOoPoOoOoOoOoOoOoOoOoOoOoMjOoOoOoOoOoOoOoMjOoOoOoOoPoOoOoMjOoNn
EbOoBpOoOoOoOoOoOoOoOoOoOoMjOoOoOoOoOoOoOoMjOoOoOoOoBpOoOoMjOoNn
EdOoBpOoOoOoOoOoOoOoOoOoOoMkOoOoOoOoOoOoOoMkOoOoOoOoBpOoOoMkOoNn
EdOoBpOoOoOoOoOoAeAaAaAaAaAgAaAaAaAaAaAaAaAgAaAaAaAaAbAaAaAgAaAa
EdOoBpOoJdJpJeOoDfDgBoDeDfKpKoKoKoKoKoKoKoKpKoKoKoKoKoKoKoKpDhDe
EbOoBpOoKdJoKeOoOoOoBpOoOoMjOoOoOoOoOoOoOoOoOoOoOoOoOoOoOoMjOoNn
EdOoBpOoJbPhJaOoOoOoBpOoOoMjOoOoOoOoOoOoOoOoOoOoOoOoOoOoOoMjOoNn
AnAaAbAaApAaAoAfOoOoBpOoOoMjOoOoOoOoOoOoOoOoOoOoOoOoOoOoOoMjOoNn
DdDhDgDeDfBoDgDeOoOoBpOoOoMjOoOoOoOoOoOoOoOoOoOoOoOoOoOoOoMjOoNn
EdOoOoOoOoBpOoOoOoOoBpOoOoMjOoOoOoOoOoOoOoDmFfDnOoOoOoOoOoMjOoNn
EbOoOoOoOoBpOoOoOoOoBpOoOoMkOoOoOoOoOoOoOoEmFpEnOoOoOoOoOoMkOoNn
AnAaAaAaAaAbAaAaAaAaAbAaAaAgAaAfOoOoOoOoOoOoOoOoAeAaAaAaAaAgAaAa
DdDgDhDeDfDgDhDeDfDgDhDeDfBoDhDeOoOoOoOoOoOoOoOoDfDgBoDeDfKpKoKo
EdOoOoOoOoOoOoOoOoOoOoOoOoBpOoOoOoOoOoOoOoOoOoOoOoOoBpOoOoOoOoNn
EbOoOoOoOoOoOoOoOoOoOoOoOoBpOoOoOoOoOoOoOoOoOoOoOoOoBpOoOoOoOoNn
EdOoOoOoOoOoOoOoOoOoOoOoOoBpOoOoOoOoOoOoOoFaFbFcOoOoBpOoOoOoOoNn
EdOoOoOoOoOoOoOoOoOoOoOoOoBpOoOoOoOoOoOoOoGaOoGcOoOoBpOoOoOoOoNn
AnAaAaAaAaAaAaAaAaAaAaAaAaAbAaAaAaAaAaAaAaBjAaBkAaAaAbAaAaAaAaAa
CgCfCgCfCgCfCgCfCgCfCgCfCgCfCgCfCgCfCgCfCgCfCgCfCgCfCgCfCgCfCgCf
HmGmHmGmHmGmHmGmHmGmHmGmHmGmHmGmHmGmHmGmHmGmHmGmHmGmHmGmHmGmHmGm
OdOdOdOdOdOdOdOdOdOdOdOdOdOdOdOdOdOdOdOdOdOdOdOdOdOcOeOfOfOfOdOd
OoOoOoOoOoOoOoOoOoOoOoOoOoOoOoOoOoOoOoOoOoOoOoOoOoOoOoNpNpNpOoOo
OoOoOoOoOoOoOoOoOoOoOoOoOoOoOoOoOoOoOoOoOoOoOoOoOoOoOoOoOoOoOoOo