TILEMAP
32 26 							-- Size of tile map in tiles
16 16 							-- Tile size & block size
images/TheGoonies-MapTiles2.png 	-- Tilesheet
16 16								-- Number of tiles in tilesheet
OoOoOoOoOoOoOoOoOoOoOoOoOoOoOoOoOoOoOoOoOoOoOoOoOoOoOoOoOoOoOoOo
OoNcNdNkOoOoOoOoOoOoOoNiNdNhOoOoOoOoOoOoOoOoOoOoOoOoNgNaNbNeNbOo
OoNlNfNkOoOoOoOoOoOoOoNbNjNfOoOoOoOoOoOoOoOoOoOoOoOoNmOoNkNmOoOo
DdDgDhDeDfDgDhDeDfDgDhDeDfDgDhDeDfDgDhDeDfDgDhDeDfDgDhDeDfDgDhDe
EdOoOoOoOoOoOoOoOoOoOoOoOoOoOoOoDmFfDnOoOoOoOoOoOoOoOoOoOoOoOoOo
EbOoOoOoOoOoOoOoOoOoOoOoOoOoOoOoOoOoOoOoOoOoOoOoOoOoOoOoOoOoOoOo
EdOoOoOoOoOoOoOoOoOoOoOoOoOoOoOoOoOoOoOoOoOoOoOoFaFbFcOoOoOoOoOo
PpOoOoOoOoOoOoOoOoOoOoOoOoOoOoOoOoOoOoOoOoOoOoOoGaOoGcOoOoOoOoOo
PpOoOoOoOoOoOoOoAeAaAaAaAaAaAaAaAaAaAaAaAaAaAaAaBjAaBkAaAaAaAaAa
PpOoOoOoOoOoOoOoDfDgBoDeDfDgDhDeDfDgDhDeDfDgDhDeDfDhDgDeDfDhDgDe
PpOoOoOoOoOoOoOoOoOoBpOoOoOoOoOoOoOoOoOoOoOoOoOoOoOoOoOoOoOoOoOo
PpOoOoOoOoOoOoOoOoOoBpOoOoOoOoOoOoOoOoOoOoOoOoOoOoOoOoOoOoOoOoOo
AaAaAaAaAaAaAaAaAaAaAbAfAcAdAdAdAdAdAdAdAdAdAdAdAdAdAdAcAeAaAaAa
DdDgDhDeDfDgDhDeDfDgDhFdGeGdGdGdGdGdGdGdGdGdGdGdGdGdGdGeFeDhDgDf
EdOoOoOoOoOoOoOoOoOoOoOoOoOoOoOoOoOoOoOoOoOoOoOoOoOoOoOoOoOoOoOo
EdOoOoOoOoOoOoOoOoOoOoOoOoOoOoOoOoOoOoOoOoOoOoOoOoOoOoOoOoOoOoOo
EbOoOoOoOoOoOoOoOoOoOoOoOoOoOoOoOoOoOoOoOoOoOoOoOoOoOoOoOoOoOoOo
EdOoOoOoOoOoOoOoOoOoOoOoOoOoOoOoOoOoOoOoOoOoOoOoOoOoOoOoOoOoOoOo
EdOoOoOoOoOoOoOoOoOoOoOoOoOoOoOoOoOoOoOoOoOoOoOoOoOoOoOoOoOoOoOo
HmGmHmGmHmGmHmGmHmGmHmGmHmGmHmGmHmGmHmGmHmGmHmGmHmGmHmGmHmGmHmGm
GmHmGmHmGmHmGmHmGmHmGmHmGmHmGmHmGmHmGmHmGmHmGmHmGmHmGmHmGmHmGmHm
HmGmHmGmHmGmHmGmHmGmHmGmHmGmHmGmHmGmHmGmHmGmHmGmHmGmHmGmHmGmHmGm
GmHmGmHmGmHmGmHmGmHmGmHmGmHmGmHmGmHmGmHmGmHmGmHmGmHmGmHmGmHmGmHm
OdOdOdOdOdOdOdOdOdOdOdOdOdOdOdOdOdOdOdOdOdOdOdOdOdOcOeOfOfOfOdOd
OoOoOoOoOoOoOoOoOoOoOoOoOoOoOoOoOoOoOoOoOoOoOoOoOoOoOoNpNpNpOoOo
OoOoOoOoOoOoOoOoOoOoOoOoOoOoOoOoOoOoOoOoOoOoOoOoOoOoOoOoOoOoOoOo