TILEMAP
32 20 							-- Size of tile map in tiles
16 16 							-- Tile size & block size
images/TheGoonies-MapTiles.png 	-- Tilesheet
16 16								-- Number of tiles in tilesheet
GmGnGmGnGmGnGmGnGmGnGmGnGmGnGmGnGmGnGmGnGmGnGmGnGmGnGmGnGmGnGmGn
GnGmGnGmGnGmGnGmGnGmGnGmGnGmGnGmGnGmGnGmGnGmGnGmGnGmGnGmGnGmGnGm
GmGnGmGnGmGnGmGnGmGnGmGnGmGnGmGnGmGnGmGnGmGnGmGnGmGnGmGnGmGnGmGn
GnGmGnGmGnGmGnGmGnGmGnGmGnGmGnGmGnGmGnGmGnGmGnGmGnGmGnGmGnGmGnGm
EdAnAoDdEfAnAoDdEfAnAoDdEfAnAoDdEfAoAnDdEfAoAnDbEdAnAoDdEfAnAoDd
EaOoOoOoOoOoOoOoOoOoOoOoOoOoOoFeFfOoOoOoOoOoOoGjEaOoOoOoOoOoOoOo
EbOoOoOoOoOoOoOoOoOoOoOoCgCmHaOoOoOoOoOoOoOoOoGkEbOoOoOoOoOoOoOo
EaOoOoOoOoOoOoOoHoMbEkOoChOoHbOoOoOoOoOoOoOoOoGjEaOoOoOoOoOoOoOo
EaOoOoOoOoOoOoOoDhOoEjOoJpOoHcOoOoOoOoOoOoOoOoOoOoOoOoOoOoOoOoOo
EbOoOoHnAaAaAaAaHmAaJdAaHgAaHhAaAaAaAaAaJeOoOoOoOoOoOoHnAaAaAaAa
EcOoOoAnAmFcAoDdEfAoAnDdEfAoAnDdEfAoFcAmAnOoOoOoOoOoOoAnAmFcAoDb
EaOoOoOoOoFdOoFeFfOoOoOoOoOoOoOoOoOoFdOoOoOoOoOoOoOoOoOoOoFdOoGk
EaOoOoOoOoFdOoOoOoOoOoOoOoOoOoOoOoOoFdOoOoOoOoJfBpKfOoOoOoFdOoGj
EbOoOoOoOoFdOoOoOoOoHoMbEkOoOoOoOoOoFdOoOoOoOoMeMfMgOoOoOoFdOoGk
EaOoOoOoOoFdOoOoOoOoDhOoEjOoOoOoOoOoFdOoOoOoOoMhOoMjOoOoOoFdOoGj
EeAaAaAaAaAbAaAaAaAaHmAaJdAaAaAaAaAaAbAaAaAaAaBeAaBfAaAaAaAbAaDc
GmGnGmGnGmGnGmGnGmGnGmGnGmGnGmGnGmGnGmGnGmGnGmGnGmGnGmGnGmGnGmGn
GnGmGnGmGnGmGnGmGnGmGnGmGnGmGnGmGnGmGnGmGnGmGnGmGnGmGnGmGnGmGnGm
GmGnGmGnGmGnGmGnGmGnGmGnGmGnGmGnGmGnGmGnGmGnGmGnGmGnGmGnGmGnGmGn
GnGmGnGmGnGmGnGmGnGmGnGmGnGmGnGmGnGmGnGmGnGmGnGmGnGmGnGmGnGmGnGm

