TILEMAP
32 26 							-- Size of tile map in tiles
16 16 							-- Tile size & block size
images/TheGoonies-MapTiles2.png 	-- Tilesheet
16 16								-- Number of tiles in tilesheet
OoOoOoOoOoOoOoOoOoOoOoOoOoOoOoOoOoOoOoOoOoOoOoOoOoOoOoOoOoOoOoOo
OoNcNdNkOoOoOoOoOoOoOoNiNdNhOoOoOoOoOoOoOoOoOoOoOoOoNgNaNbNeNbOo
OoNlNfNkOoOoOoOoOoOoOoNbNjNfOoOoOoOoOoOoOoOoOoOoOoOoNmOoNkNmOoOo
EgEhEgEhEgEhEgEhEgEhEgEhEgEhEgEhEgEhEgEhEgEhEgEhEgEhEgEhEgEhEgEh
EhEgEhEgEhEgEhEgEhEgEhEgEhEgEhEgEhEgEhEgEhEgEhEgEhEgEhEgEhEgEhEg
EgEhEgEhEgEhEgEhEgEhEgEhEgEhEgEhEgEhEgEhEgEhEgEhEgEhEgEhEgEhEgEh
EhEgEhEgEhEgEhEgEhEgEhEgEhEgEhEgEhEgEhEgEhEgEhEgEhEgEhEgEhEgEhEg
DdDgDhDeDfDgDhDeDfDgDhDeDfDgDhDeDfDgDhDeDfDgDhDeDfDhDgDeDfDhDgDc
EdOoOoOoOoOoOoOoOoOoOoOoOoOoOoOoOoOoOoOoOoOoOoOoOoOoOoOoOoOoOoEc
EbOoOoOoOoOoOoOoOoOoOoOoOoOoOoOoOoOoJdJpJeOoOoOoOoOoOoOoOoOoOoEa
EdOoOoOoOoOoOoOoOoOoOoOoOoOoOoOoOoOoKdJoKeOoOoOoOoOoOoOoOoOoOoEc
PpOoOoOoOoOoOoOoOoOoOoOoOoOoOoOoOoOoJbPcJaOoOoOoOoOoOoOoOoOoOoEc
PpOoOoOoOoOoOoOoOoOoOoAeAaAaAaAaAaAaApAaAoAaAaAaAaAaAaAaAfOoOoEa
PpOoOoOoOoOoOoOoOoOoOoDgFhBoDhDeDfDgDhDeDfDgDhDeDfDhBoFhDgOoOoDa
AaAaAaAaAaAaAaAfOoOoOoOoOoBpOoOoOoOoOoOoOoOoOoOoOoOoBpOoOoOoOoEc
DdDgDhDeDfDgDhDeOoOoOoOoOoBpOoOoOoOoOoOoOoOoOoOoOoOoBpOoOoOoOoEc
EdOoOoOoOoOoOoOoOoOoOoOoOoBpOoOoOoOoOoOoOoOoOoOoOoOoBpOoOoOoOoEa
EbOoOoOoOoOoOoOoOoOoOoOoOoBpOoOoOoOoOoOoOoOoOoOoOoOoBpOoOoOoOoEc
AnAaAaAaAaAaAaAaAaAaAaAaAaAbAaAaAaAaAaAaAaAaAaAaAaAaAbAaAaAaAaAm
DdDgDhDeDfDgDhDeDfDhDgDeDfDhDgDcDdDgDhDeDfDgDhDeDfDhDgDeDfDhDgDc
EdOoOoOoOoOoOoOoOoOoOoOoOoOoOoEcEdOoOoOoOoOoOoOoOoOoOoOoOoOoOoEc
DbOoOoOoOoOoOoOoOoOoOoOoOoOoOoEcEdOoOoOoOoOoOoOoOoOoOoOoOoOoOoEa
EbOoOoOoOoOoOoOoOoOoOoOoOoOoOoEcEdOoOoOoOoOoOoOoOoOoOoOoOoOoOoEa
OdOdOdOdOdOdOdOdOdOdOdOdOdOdOdOdOdOdOdOdOdOdOdOdOdOcOeOfOfOfOdOd
OoOoOoOoOoOoOoOoOoOoOoOoOoOoOoOoOoOoOoOoOoOoOoOoOoOoOoNpNpNpOoOo
OoOoOoOoOoOoOoOoOoOoOoOoOoOoOoOoOoOoOoOoOoOoOoOoOoOoOoOoOoOoOoOo