TILEMAP
32 26 							-- Size of tile map in tiles
16 16 							-- Tile size & block size
images/TheGoonies-MapTiles2-3.png 	-- Tilesheet
16 16								-- Number of tiles in tilesheet
OoOoOoOoOoOoOoOoOoOoOoOoOoOoOoOoOoOoOoOoOoOoOoOoOoOoOoOoOoOoOoOo
OoNcNdNkOoOoOoOoOoOoOoNiNdNhOoOoOoOoOoOoOoOoOoOoOoOoNgNaNbNeNbOo
OoNlNfNkOoOoOoOoOoOoOoNbNjNfOoOoOoOoOoOoOoOoOoOoOoOoNmOoNkNmOoOo
EdOoOoOoOoOoOoOoOoOoPoOoOoOoOoOoOoOoOoOoOoOoOoOoOoOoPoOoOoOoOoEc
EdOoOoOoOoOoOoOoOoOoBpOoOoOoOoOoOoOoOoOoOoOoOoOoOoOoBpOoOoOoOoEa
EbOoOoOoOoOoOoOoOoOoBpOoOoOoOoOoOoOoOoOoOoOoOoOoOoOoBpOoOoOoOoEc
AnAaAaAaAaAaAaAaAaAaAbAaAaAaAaAaAaAaAaAaAaAaAaAaAaAaAbAaAaAaAaAm
DdDgBoDeDfDgDhDeDfDgDhDeDfBoDhDeDfDgDhDeDfDgDhDeDfDhDgDeDfDhDgDc
EdOoBpOoOoOoOoOoOoOoOoOoOoBpOoOoOoOoOoOoOoOoOoOoOoOoOoOoOoOoOoEc
EbOoBpOoOoOoOoOoOoOoOoOoOoBpOoOoOoOoOoOoOoOoOoOoOoOoOoOoOoOoOoEa
EdOoBpOoOoOoOoOoOoOoOoOoOoBpOoOoOoOoOoOoOoOoOoOoOoOoOoOoOoOoOoEc
EdOoBpOoOoOoOoOoOoOoOoOoOoBpOoOoOoOoOoOoOoOoOoOoOoOoOoOoOoOoOoEa
AnAaAbAaAaAaAaAaAaAaAaAaAaAbAaAaAaAaAaAaAaAaAaAfOoOoOoAeAaAaAaAm
DdDgDhDeDfDgDhDeDfDhDgDeDfDhDgDeDfDhDgDeDfDhDgDeOoOoOoDgFhBoDhDc
EdOoOoOoOoOoOoOoOoOoOoOoOoOoOoOoOoOoOoOoOoOoOoOoOoOoOoOoOoBpOoEc
EdOoOoOoOoOoOoOoOoOoOoOoOoOoOoOoOoOoOoOoJfJgJhOoOoOoOoOoOoBpOoEc
EbOoOoOoOoOoOoOoOoOoOoOoOoFaFbFcOoOoOoOoMcMdMeOoOoOoOoOoOoBpOoEa
EdOoOoOoOoOoOoOoOoOoOoOoOoGaOoGcOoOoOoOoMfOoMbOoOoOoOoOoOoBpOoEc
AnAaAaAaAaAaAaAaAaAaAaAaAaBjAaBkAaAaAaAaBhAaBdAaAaAaAaAaAaAbAaAm
DdDgDhDeDfDgDhDeDfDgDhDeDfDhDgDeDfDgDhDeDfDgDhDeDfDhDgDeDfBoDgDc
EbOoOoOoOoOoOoOoOoOoOoOoOoOoOoOoOoOoOoOoOoOoOoOoOoOoOoOoOoBpOoEc
EdOoOoOoOoOoOoOoOoOoOoOoOoOoOoOoOoOoOoOoOoOoOoOoOoOoOoOoOoBpOoEa
EdOoOoOoOoOoOoOoOoOoOoOoOoOoOoOoOoOoOoOoOoOoOoOoOoOoOoOoOoPnOoEc
OdOdOdOdOdOdOdOdOdOdOdOdOdOdOdOdOdOdOdOdOdOdOdOdOdOcOeOfOfOfOdOd
OoOoOoOoOoOoOoOoOoOoOoOoOoOoOoOoOoOoOoOoOoOoOoOoOoOoOoNpNpNpOoOo
OoOoOoOoOoOoOoOoOoOoOoOoOoOoOoOoOoOoOoOoOoOoOoOoOoOoOoOoOoOoOoOo