TILEMAP
32 26 							-- Size of tile map in tiles
16 16 							-- Tile size & block size
images/TheGoonies-MapTiles2.png 	-- Tilesheet
16 16								-- Number of tiles in tilesheet
OoOoOoOoOoOoOoOoOoOoOoOoOoOoOoOoOoOoOoOoOoOoOoOoOoOoOoOoOoOoOoOo
OoNcNdNkOoOoOoOoOoOoOoNiNdNhOoOoOoOoOoOoOoOoOoOoOoOoNgNaNbNeNbOo
OoNlNfNkOoOoOoOoOoOoOoNbNjNfOoOoOoOoOoOoOoOoOoOoOoOoNmOoNkNmOoOo
DdDgDhDeDfDgDhDeDfDgDhDeDfKpDhDeDfDgDhDeDfKpKoKoKoKoKoKoKoKpDhDc
EdOoOoOoOoOoOoOoOoOoOoOoOoMjOoOoOoOoOoOoOoMjOoOoOoOoOoOoOoMjOoEc
EbOoOoOoOoOoOoOoOoOoOoOoOoMjOoOoOoOoOoOoOoMjOoOoOoOoOoOoOoMjOoEa
EdOoOoOoOoOoOoOoOoOoOoOoOoMjOoOoOoOoOoOoOoMjOoOoOoOoOoOoOoMjOoEa
EdOoOoOoOoOoOoOoOoOoOoOoOoMjOoOoOoOoOoOoOoMjOoOoJdJpJeOoOoMjOoEc
AnAaAaAaAaAaAaAfOoOoOoOoOoMjOoOoOoOoOoOoOoMjOoOoKdJoKeOoOoMjOoEa
DdDhDgDeDfBoDgDeOoOoOoOoOoMkOoOoOoOoOoOoOoMkOoOoJbPjJaOoOoMkOoEc
EbOoOoOoOoBpOoOoAeAaAaAaAaAgAaAaAaAaAaAaAaAgAaAaApAaAoAaAaAgAaAm
EdOoOoOoOoBpOoOoDfDgBoDeDfKpKoKoKoKoKoKoKoKpKoKoKoKoKoKoKoKpDhDc
EbOoOoOoOoBpOoOoOoOoBpOoOoMjOoOoOoOoOoOoOoMjOoOoOoOoOoOoOoMjOoEc
EdOoOoOoOoBpOoOoOoOoBpOoOoMjOoOoOoOoOoOoOoMjOoOoOoOoOoOoOoMjOoEa
AnAaAaAaAaAbAaAfOoOoBpOoOoMjOoOoOoOoOoOoOoMjOoOoOoOoOoOoOoMjOoEc
DdDgBoDeDfDgDhDeOoOoBpOoOoMjOoOoOoJfJgJhOoMjOoOoOoOoOoOoOoMjOoEc
EdOoBpOoOoOoOoOoOoOoBpOoOoMjOoOoOoMcMdMeOoMjOoOoOoOoOoOoOoMjOoEa
EbOoBpOoOoOoOoOoOoOoBpOoOoMkOoOoOoMfOoMbOoMkOoOoOoOoOoOoOoMkOoEc
EdOoBpOoOoOoOoOoAeAaAbAaAaAgAaAaAaBhAaBdAaAgAaAaAaAaAaAaAaAgAaAm
EdOoBpOoOoOoOoOoDfDgDhDeDfKpKoKoKoKoKoKoKoKpDhDeDfDgBoDeDfKpKoKo
EbOoBpOoOoOoOoOoOoOoOoOoOoMjOoOoOoOoOoOoOoMjOoOoOoOoBpOoOoMjOoOo
EdOoBpOoOoOoOoOoOoOoOoOoOoMjOoOoOoOoOoOoOoMjOoOoOoOoBpOoOoMjOoOo
EdNnPnNnNnNnNnNnNnNnNnNnNnMjNnNnNnNnNnNnNnMjNnNnNnNnPnNnNnMjNnNn
OdOdOdOdOdOdOdOdOdOdOdOdOdOdOdOdOdOdOdOdOdOdOdOdOdOcOeOfOfOfOdOd
OoOoOoOoOoOoOoOoOoOoOoOoOoOoOoOoOoOoOoOoOoOoOoOoOoOoOoNpNpNpOoOo
OoOoOoOoOoOoOoOoOoOoOoOoOoOoOoOoOoOoOoOoOoOoOoOoOoOoOoOoOoOoOoOo