TILEMAP
32 26 							-- Size of tile map in tiles
16 16 							-- Tile size & block size
images/TheGoonies-MapTiles2.png 	-- Tilesheet
16 16								-- Number of tiles in tilesheet
OoOoOoOoOoOoOoOoOoOoOoOoOoOoOoOoOoOoOoOoOoOoOoOoOoOoOoOoOoOoOoOo
OoNcNdNkOoOoOoOoOoOoOoNiNdNhOoOoOoOoOoOoOoOoOoOoOoOoNgNaNbNeNbOo
OoNlNfNkOoOoOoOoOoOoOoNbNjNfOoOoOoOoOoOoOoOoOoOoOoOoNmOoNkNmOoOo
DfDhDgDeDfDhDgDcEgEhEgEhEgEhEgEhEgEhEgEhEgEhEgEhEgEhEgEhEgEhEgEh
PpOoOoOoOoOoOoEcEhEgEhEgEhEgEhEgEhEgEhEgEhEgEhEgEhEgEhEgEhEgEhEg
PpOoOoOoOoOoOoEaEgEhEgEhEgEhEgEhEgEhEgEhEgEhEgEhEgEhEgEhEgEhEgEh
PpOoOoOoOoOoOoEcEhEgEhEgEhEgEhEgEhEgEhEgEhEgEhEgEhEgEhEgEhEgEhEg
PpOoOoOoOoOoOoOoDfDgDhDeDfDgDhDeDfDhDgDeDfDhDgDeDfDhDgDeDfDhDgDc
PpOoOoOoOoOoOoOoOoOoOoOoOoOoOoOoOoOoOoOoOoOoDmFfDnOoOoOoOoOoOoEc
PpOoOoOoOoOoOoOoOoOoOoJfJgJhOoOoOoOoOoOoOoOoEmFpEnOoOoOoOoOoOoEa
PpOoOoOoOoFaFbFcOoOoOoMcMdMeOoOoOoOoOoOoOoOoOoOoOoOoOoOoOoOoOoEc
PpOoOoOoOoGaOoGcOoOoOoMfOoMbOoOoOoOoOoOoOoOoOoOoOoOoOoOoOoOoOoNn
AaAaAaAaAaBjAaBkAaAaAaBhAaBdAaAfOoOoOoOoOoFaFbFcOoOoOoOoOoOoOoNn
DfDgDhDeDfDgDhDeDfDhDgDeDfDhDgDeOoOoOoOoOoGaOoGcOoOoOoOoOoOoOoNn
OoOoOoOoOoOoOoOoOoOoOoOoOoOoOoOoAeAaAaAaAaBjAaBkAaAaAaAaAaAaAaAa
OoOoOoOoOoOoOoOoOoOoOoOoOoOoOoOoDeDgDhDeDfDgDhDeDfDhDgDeDfDhDgDc
OoOoOoOoOoOoOoOoOoOoOoOoOoOoOoOoOoOoOoOoOoOoOoOoOoOoOoOoOoOoOoEc
OoOoOoOoOoOoOoOoOoOoOoOoOoOoOoOoOoOoOoOoOoOoOoOoOoOoOoOoOoOoOoEa
OoOoOoOoOoOoOoOoOoOoOoOoOoOoOoOoOoOoOoOoOoOoOoOoOoOoOoOoOoOoOoEc
HmGmHmGmHmGmHmGmHmGmHmGmHmGmHmGmHmGmHmGmHmGmHmGmHmGmHmGmHmGmHmGm
HmGmHmGmHmGmHmGmHmGmHmGmHmGmHmGmHmGmHmGmHmGmHmGmHmGmHmGmHmGmHmGm
HmGmHmGmHmGmHmGmHmGmHmGmHmGmHmGmHmGmHmGmHmGmHmGmHmGmHmGmHmGmHmGm
HmGmHmGmHmGmHmGmHmGmHmGmHmGmHmGmHmGmHmGmHmGmHmGmHmGmHmGmHmGmHmGm
OdOdOdOdOdOdOdOdOdOdOdOdOdOdOdOdOdOdOdOdOdOdOdOdOdOcOeOfOfOfOdOd
OoOoOoOoOoOoOoOoOoOoOoOoOoOoOoOoOoOoOoOoOoOoOoOoOoOoOoNpNpNpOoOo
OoOoOoOoOoOoOoOoOoOoOoOoOoOoOoOoOoOoOoOoOoOoOoOoOoOoOoOoOoOoOoOo