TILEMAP
32 26 							-- Size of tile map in tiles
16 16 							-- Tile size & block size
images/TheGoonies-MapTiles2-2.png 	-- Tilesheet
16 16								-- Number of tiles in tilesheet
OoOoOoOoOoOoOoOoOoOoOoOoOoOoOoOoOoOoOoOoOoOoOoOoOoOoOoOoOoOoOoOo
OoNcNdNkOoOoOoOoOoOoOoNiNdNhOoOoOoOoOoOoOoOoOoOoOoOoNgNaNbNeNbOo
OoNlNfNkOoOoOoOoOoOoOoNbNjNfOoOoOoOoOoOoOoOoOoOoOoOoNmOoNkNmOoOo
EdOoOoOoOoPoOoOoOoOoOoOoOoOoJdJpJeOoPoOoOoOoOoOoOoOoOoOoOoOoOoEc
EbOoOoOoOoBpOoOoOoOoOoOoOoOoKdJoKeOoBpOoOoOoOoOoOoOoOoOoOoOoOoEa
EdOoOoOoOoBpOoOoOoOoOoOoOoOoJbPeJaOoBpOoOoOoOoOoOoOoOoOoOoOoOoEc
AnAaAaAaAaAbAaAfOoOoOoAeAaAaApAaAoAaAbAaAfOoOoOoAeAaAaAaAaAaAaAm
DdDgBoDeDfDgDhDeOoOoOoDgFhDgDhDeDfDhDgFhDgOoOoOoDfDhDgDeDfBoDgDc
EdOoBpOoOoOoOoOoOoOoOoOoOoOoOoOoOoOoOoOoOoOoOoOoOoOoOoOoOoBpOoEc
EbOoBpOoOoOoOoOoOoOoOoOoOoOoOoOoOoOoOoOoOoOoOoOoOoOoOoOoOoBpOoEa
EdOoBpOoOoOoOoOoOoOoOoOoOoOoOoOoOoOoOoOoOoOoOoOoOoOoOoOoOoBpOoEc
EdOoBpOoOoOoOoOoOoOoOoOoOoOoOoOoOoOoOoOoOoOoOoOoOoOoOoOoOoBpOoEc
AnAaAbAaAaAaAaAaAaAaAaAfAcAdAdAdAdAdAdAcAeAaAaAaAaAaAaAaAaAbAaAm
DdDgDhDeDfDgDhDeDfDgDhFdGeGdGdGdGdGdGdGeFeDhDgDeDfDhDgDeDfDhDgDc
EdOoOoOoOoOoOoOoOoOoOoOoOoOoOoOoOoOoOoOoOoOoOoOoOoOoOoOoOoOoOoEc
EdOoOoOoOoOoOoOoOoOoOoOoOoOoOoOoOoOoOoOoOoOoOoOoOoOoOoOoOoOoOoEc
EbOoOoOoOoOoOoOoOoOoOoOoOoOoOoOoOoOoOoOoOoOoOoOoOoOoOoOoOoOoOoEa
EdOoOoOoOoOoOoOoOoOoOoOoOoOoOoOoOoOoOoOoOoOoOoOoOoOoOoOoOoOoOoEc
EdOoOoOoOoOoOoOoOoOoOoOoOoOoOoOoOoOoOoOoOoOoOoOoOoOoOoOoOoOoOoEc
HmGmHmGmHmGmHmGmHmGmHmGmHmGmHmGmHmGmHmGmHmGmHmGmHmGmHmGmHmGmHmGm
HmGmHmGmHmGmHmGmHmGmHmGmHmGmHmGmHmGmHmGmHmGmHmGmHmGmHmGmHmGmHmGm
HmGmHmGmHmGmHmGmHmGmHmGmHmGmHmGmHmGmHmGmHmGmHmGmHmGmHmGmHmGmHmGm
HmGmHmGmHmGmHmGmHmGmHmGmHmGmHmGmHmGmHmGmHmGmHmGmHmGmHmGmHmGmHmGm
OdOdOdOdOdOdOdOdOdOdOdOdOdOdOdOdOdOdOdOdOdOdOdOdOdOcOeOfOfOfOdOd
OoOoOoOoOoOoOoOoOoOoOoOoOoOoOoOoOoOoOoOoOoOoOoOoOoOoOoNpNpNpOoOo
OoOoOoOoOoOoOoOoOoOoOoOoOoOoOoOoOoOoOoOoOoOoOoOoOoOoOoOoOoOoOoOo