TILEMAP
32 20 							-- Size of tile map in tiles
16 16 							-- Tile size & block size
images/TheGoonies-MapTiles2.png 	-- Tilesheet
16 16								-- Number of tiles in tilesheet
EgEhEgEhEgEhEgEhEgEhEgEhEgEhEgEhEgEhEgEhEgEhEgEhEgEhEgEhEgEhEgEh
EhEgEhEgEhEgEhEgEhEgEhEgEhEgEhEgEhEgEhEgEhEgEhEgEhEgEhEgEhEgEhEg
EgEhEgEhEgEhEgEhEgEhEgEhEgEhEgEhEgEhEgEhEgEhEgEhEgEhEgEhEgEhEgEh
EhEgEhEgEhEgEhEgEhEgEhEgEhEgEhEgEhEgEhEgEhEgEhEgEhEgEhEgEhEgEhEg
DdDgDhDeDfDgDhDeDfDgDhDeDfDgDhDeDfDhDgDeDfDhDgDcDdDgDhDeDfDgDhDe
EdOoOoOoOoOoOoOoOoOoOoOoOoOoOoEeEfOoOoOoOoOoOoEcEdOoOoOoOoOoOoOo
EbOoOoOoOoOoOoOoOoOoOoOoHbCmGkOoOoOoOoOoOoOoOoEaEbOoOoOoOoOoOoOo
EdOoOoOoOoOoOoOoFaFbFcOoMaOoHkOoOoOoOoOoOoOoOoEcEdOoOoOoOoOoOoOo
EdOoOoOoOoOoOoOoGaOoGcOoHeOoHcOoOoOoOoOoOoOoOoOoOoOoOoOoOoOoOoOo
EbOoOoAeAaAaAaAaBjAaBkAaCaAaCbAaAaAaAaAaAfOoOoOoOoOoOoAeAaAaAaAa
DbOoOoDgFhBoDhDeDfDhDgDeDfDhDgDeDfDhBoFhDgOoOoOoOoOoOoDgFhBoDhDc
EdOoOoOoOoBpOoEeEfOoOoOoOoOoOoOoOoOoBpOoOoOoOoOoOoOoOoOoOoBpOoEa
EdOoOoOoOoBpOoOoOoOoOoOoOoOoOoOoOoOoBpOoOoOoOoJfJgJhOoOoOoBpOoEc
EbOoOoOoOoBpOoOoOoOoFaFbFcOoOoOoOoOoBpOoOoOoOoMcMdMeOoOoOoBpOoEa
EdOoOoOoOoBpOoOoOoOoGaOoGcOoOoOoOoOoBpOoOoOoOoMfOoMbOoOoOoBpOoEc
AnAaAaAaAaAbAaAaAaAaBjAaBkAaAaAaAaAaAbAaAaAaAaBhAaBdAaAaAaAbAaAm
EgEhEgEhEgEhEgEhEgEhEgEhEgEhEgEhEgEhEgEhEgEhEgEhEgEhEgEhEgEhEgEh
EhEgEhEgEhEgEhEgEhEgEhEgEhEgEhEgEhEgEhEgEhEgEhEgEhEgEhEgEhEgEhEg
EgEhEgEhEgEhEgEhEgEhEgEhEgEhEgEhEgEhEgEhEgEhEgEhEgEhEgEhEgEhEgEh
EhEgEhEgEhEgEhEgEhEgEhEgEhEgEhEgEhEgEhEgEhEgEhEgEhEgEhEgEhEgEhEg
