TILEMAP
32 26 							-- Size of tile map in tiles
16 16 							-- Tile size & block size
images/TheGoonies-MapTiles2-3.png 	-- Tilesheet
16 16								-- Number of tiles in tilesheet
OoOoOoOoOoOoOoOoOoOoOoOoOoOoOoOoOoOoOoOoOoOoOoOoOoOoOoOoOoOoOoOo
OoNcNdNkOoOoOoOoOoOoOoNiNdNhOoOoOoOoOoOoOoOoOoOoOoOoNgNaNbNeNbOo
OoNlNfNkOoOoOoOoOoOoOoNbNjNfOoOoOoOoOoOoOoOoOoOoOoOoNmOoNkNmOoOo
DdDgDhDeDfDgDhDeDfDgDhDeDfDgDhDeDfDgDhDeDfDgDhDeDfDhDgDeDfDhDgDc
EdOoOoOoOoOoOoOoOoOoOoOoOoOoOoOoOoOoOoOoOoOoOoOoOoOoOoOoOoOoOoEc
EbOoOoOoOoOoOoOoOoOoOoOoOoOoOoOoOoOoOoOoOoOoOoJdJpJeOoOoOoOoOoEa
EdOoOoOoOoOoOoOoOoOoOoOoOoOoOoOoOoOoOoOoOoOoOoKdJoKeOoOoOoOoOoEc
EdOoOoOoOoOoOoOoOoOoOoOoOoOoOoOoOoOoOoOoOoOoOoJbPiJaOoOoOoOoOoEc
EbOoOoOoOoOoOoOoOoOoOoOoOoOoOoOoAeAaAaAaAaAaAaApAaAoAaAaAfOoOoEa
EdOoOoOoOoOoOoOoOoOoOoOoOoOoOoOoDfDgBoDeDfDgDhDeDfDhBoFhDgOoOoEc
EdOoOoOoOoOoOoOoOoOoOoOoOoOoOoOoOoOoBpOoOoOoOoOoOoOoBpOoOoOoOoEc
EdOoOoOoOoOoOoOoOoOoOoOoOoOoOoOoOoOoBpOoOoOoOoOoOoOoBpOoOoOoOoEc
EbOoOoAeAaAaAaAaAaAaAaAaAaAaAaAaAaAaAbAaAaAaAaAaAaAaAbAaAfOoOoEa
EdOoOoDgFhBoDhDeDfDgDhDeDfDgDhDeDfDgDhDeDfDgDhDeDfDhDgFhDgOoOoEc
EdOoOoOoOoBpOoOoOoOoOoOoOoOoOoOoOoOoOoOoOoOoOoOoOoOoOoOoOoOoOoEa
EdOoOoOoOoBpOoOoOoOoOoOoOoOoOoOoOoOoOoOoOoOoOoOoOoOoOoOoOoOoOoEc
EbOoOoOoOoBpOoOoFaFbFcOoOoOoOoOoAeAaAaAaAaAaAaAaAaAaAaAaAaAaAaAm
EdOoOoOoOoBpOoOoGaOoGcOoOoOoOoOoDfDgDhDeDfDgDhDeDfDhBoDeDfDhDgDc
AnAaAaAaAaAbAaAaBjAaBkAaAaAaAaAfOoOoOoOoOoOoOoOoOoOoBpOoOoOoOoEa
DdDgDhDeDfDgDhDeDfDhBoDeDfDhDgDeOoOoOoOoOoOoOoOoOoOoBpOoOoOoOoEc
EdOoOoOoOoOoOoOoOoOoBpOoOoOoOoOoOoOoOoOoOoOoOoOoOoOoBpOoOoOoOoEa
EbOoOoOoOoOoOoOoOoOoBpOoOoOoOoOoOoOoOoOoOoOoOoOoOoOoBpOoOoOoOoEc
EdOoOoOoOoOoOoOoOoOoPnOoOoOoOoOoOoOoOoOoOoOoOoOoOoOoPnOoOoOoOoEc
OdOdOdOdOdOdOdOdOdOdOdOdOdOdOdOdOdOdOdOdOdOdOdOdOdOcOeOfOfOfOdOd
OoOoOoOoOoOoOoOoOoOoOoOoOoOoOoOoOoOoOoOoOoOoOoOoOoOoOoNpNpNpOoOo
OoOoOoOoOoOoOoOoOoOoOoOoOoOoOoOoOoOoOoOoOoOoOoOoOoOoOoOoOoOoOoOo