TILEMAP
32 26 							-- Size of tile map in tiles
16 16 							-- Tile size & block size
images/TheGoonies-MapTiles2.png 	-- Tilesheet
16 16								-- Number of tiles in tilesheet
OoOoOoOoOoOoOoOoOoOoOoOoOoOoOoOoOoOoOoOoOoOoOoOoOoOoOoOoOoOoOoOo
OoNcNdNkOoOoOoOoOoOoOoNiNdNhOoOoOoOoOoOoOoOoOoOoOoOoNgNaNbNeNbOo
OoNlNfNkOoOoOoOoOoOoOoNbNjNfOoOoOoOoOoOoOoOoOoOoOoOoNmOoNkNmOoOo
DfDhDgDeDfDhDgDeDfDgDhDeDfDgDhDeDfDgDhDeDfDgDhDeDfDhDgDeDfDhDgDc
PpOoOoOoOoOoOoOoOoOoOoOoOoOoOoOoOoOoOoOoOoOoOoOoOoOoOoOoOoOoOoEc
PpOoOoOoOoOoOoOoOoOoOoOoOoJdJpJeOoOoOoOoOoOoOoOoJdJpJeOoOoOoOoEa
PpOoOoOoOoOoOoOoOoOoOoOoOoKdJoKeOoOoOoOoOoOoOoOoKdJoKeOoOoOoOoEc
PpOoOoOoOoOoOoOoOoOoOoOoOoJbPaJaOoOoOoOoOoOoOoOoJbPbJaOoOoOoOoEc
AaAaAaAaAaAaAaAfOoOoOoAeAaApAaAoAaAaAaAaAaAaAaAaApAaAoAaAaOoOoEa
DfDhBoDeDfDhDgDeOoOoOoDgFhDgDhDeDfDgBoDeDfDgDhDeDfDhDgFhDgOoOoDa
PpOoBpOoOoOoOoOoOoOoOoOoOoOoOoOoOoOoBpOoOoOoOoOoOoOoOoOoOoOoOoEc
PpOoBpOoOoOoOoOoOoOoOoOoOoOoOoOoOoOoBpOoOoOoOoOoOoOoOoOoJfJgJhEc
AaAaAbAaAaAaAaAfOoOoOoOoOoOoOoOoOoOoBpOoOoOoOoOoOoOoOoOoMcMdMeEc
DfDhDgDeDfBoDgDeOoOoOoOoOoOoOoOoOoOoBpOoOoOoOoOoOoOoOoOoMfOoMbEa
EdOoOoOoOoBpOoOoOoOoOoOoOoOoOoOoAeAaAbAaAaAaAaAaAaAaAaAaBhAaBdAm
EdOoOoOoOoBpOoOoOoOoOoOoOoOoOoOoDfDhDgDeDfBoDgDcEgEhEgEhEgEhEgEh
EbOoOoOoOoBpOoOoFaFbFcOoOoOoOoOoOoOoOoOoOoBpOoEcEhEgEhEgEhEgEhEg
EdOoOoOoOoBpOoOoGaOoGcOoOoOoOoOoOoOoOoOoOoBpOoEaEgEhEgEhEgEhEgEh
AnAaAaAaAaAbAaAaBjAaBkAaAaAaAaAfOoOoOoOoOoBpOoEcEhEgEhEgEhEgEhEg
DdDgDhDeDfDgDhDeDfDhDgDeDfBoDgDeOoOoOoOoOoBpOoEcEgEhEgEhEgEhEgEh
EdOoOoOoOoOoOoOoOoOoOoOoOoBpOoOoOoOoOoOoOoBpOoEaEhEgEhEgEhEgEhEg
EbOoOoOoOoOoOoOoOoOoOoOoOoBpOoOoOoOoOoOoOoBpOoEcEgEhEgEhEgEhEgEh
AnAaAaAaAaAaAaAaAaAaAaAaAaAbAaAaAaAaAaAaAaAbAaAmEhEgEhEgEhEgEhEg
OdOdOdOdOdOdOdOdOdOdOdOdOdOdOdOdOdOdOdOdOdOdOdOdOdOcOeOfOfOfOdOd
OoOoOoOoOoOoOoOoOoOoOoOoOoOoOoOoOoOoOoOoOoOoOoOoOoOoOoNpNpNpOoOo
OoOoOoOoOoOoOoOoOoOoOoOoOoOoOoOoOoOoOoOoOoOoOoOoOoOoOoOoOoOoOoOo