TILEMAP
32 26 							-- Size of tile map in tiles
16 16 							-- Tile size & block size
images/TheGoonies-MapTiles2.png 	-- Tilesheet
16 16								-- Number of tiles in tilesheet
OoOoOoOoOoOoOoOoOoOoOoOoOoOoOoOoOoOoOoOoOoOoOoOoOoOoOoOoOoOoOoOo
OoNcNdNkOoOoOoOoOoOoOoNiNdNhOoOoOoOoOoOoOoOoOoOoOoOoNgNaNbNeNbOo
OoNlNfNkOoOoOoOoOoOoOoNbNjNfOoOoOoOoOoOoOoOoOoOoOoOoNmOoNkNmOoOo
DdDeDfDhDgDeDfDgDhDeDfDhDgDeDfDeDfDgDhDeDfDgDhDeDfDgDhDeDfDgDhDe
EdOoOoOoOoOoOoOoFaFbFcOoOoOoOoOoDmFfDnOoOoOoOoOoOoOoOoOoOoOoOoNn
EbOoOoOoOoOoOoOoGaOoGcOoOoOoOoOoEmFpEnOoOoOoOoOoOoOoOoOoOoOoOoNn
AnAaAaAaAaAaAaAaBjAaBkAaAaAaAaAfOoOoOoOoOoOoOoOoOoOoOoOoOoOoOoNn
DdDgBoDeDfDgDhDeDfDgDhDeDfDgDhDeOoOoOoOoOoOoOoOoOoOoOoOoOoOoOoNn
EdOoBpOoOoOoOoOoOoOoOoOoOoOoOoOoOoOoOoOoDmFfDnOoOoOoOoOoOoOoOoNn
EdOoBpOoOoOoJdJpJeOoOoOoOoOoOoOoOoOoOoOoEmFpEnOoOoOoOoOoOoOoOoNn
EdOoBpOoOoOoKdJoKeOoOoOoOoOoOoOoOoOoOoOoOoOoOoOoOoOoOoOoOoOoOoNn
EdOoBpOoOoOoJbPgJaOoOoOoOoOoOoOoOoOoOoOoOoOoOoOoOoOoOoOoOoOoOoNn
AnAaAbAaAaAaApAaAoAaAaAfAcAdAdAdAdAdAdAdAdAdAdAdAdAdAdAcAeAaAaAa
DdDgDhDeDfDgDhDeDfDgDhFdGeGdGdGdGdGdGdGdGdGdGdGdGdGdGdGdFeDhDgDe
EdOoOoOoOoOoOoOoOoOoOoOoOoOoOoOoOoOoOoOoOoOoOoOoOoOoOoOoOoOoOoOo
EdOoOoOoOoOoOoOoOoOoOoOoOoOoOoOoOoOoOoOoOoOoOoOoOoOoOoOoOoOoOoOo
EbOoOoOoOoOoOoOoOoOoOoOoOoOoOoOoOoOoOoOoOoOoOoOoOoOoOoOoOoOoOoOo
EdOoOoOoOoOoOoOoOoOoOoOoOoOoOoOoOoOoOoOoOoOoOoOoOoOoOoOoOoOoOoOo
EdOoOoOoOoOoOoOoOoOoOoOoOoOoOoOoOoOoOoOoOoOoOoOoOoOoOoOoOoOoOoOo
HmGmHmGmHmGmHmGmHmGmHmGmHmGmHmGmHmGmHmGmHmGmHmGmHmGmHmGmHmGmHmGm
HmGmHmGmHmGmHmGmHmGmHmGmHmGmHmGmHmGmHmGmHmGmHmGmHmGmHmGmHmGmHmGm
HmGmHmGmHmGmHmGmHmGmHmGmHmGmHmGmHmGmHmGmHmGmHmGmHmGmHmGmHmGmHmGm
HmGmHmGmHmGmHmGmHmGmHmGmHmGmHmGmHmGmHmGmHmGmHmGmHmGmHmGmHmGmHmGm
OdOdOdOdOdOdOdOdOdOdOdOdOdOdOdOdOdOdOdOdOdOdOdOdOdOcOeOfOfOfOdOd
OoOoOoOoOoOoOoOoOoOoOoOoOoOoOoOoOoOoOoOoOoOoOoOoOoOoOoNpNpNpOoOo
OoOoOoOoOoOoOoOoOoOoOoOoOoOoOoOoOoOoOoOoOoOoOoOoOoOoOoOoOoOoOoOo