TILEMAP
32 26 							-- Size of tile map in tiles
16 16 							-- Tile size & block size
images/TheGoonies-MapTiles2.png 	-- Tilesheet
16 16								-- Number of tiles in tilesheet
OoOoOoOoOoOoOoOoOoOoOoOoOoOoOoOoOoOoOoOoOoOoOoOoOoOoOoOoOoOoOoOo
OoNcNdNkOoOoOoOoOoOoOoNiNdNhOoOoOoOoOoOoOoOoOoOoOoOoNgNaNbNeNbOo
OoNlNfNkOoOoOoOoOoOoOoNbNjNfOoOoOoOoOoOoOoOoOoOoOoOoNmOoNkNmOoOo
PpOoOoOoOoMjOoOoOoOoOoOoOoOoOoOoOoOoOoOoOoMjOoOoOoOoOoOoJfJgJhEc
PpOoOoOoOoMjOoOoOoOoOoOoOoDmFfDnOoOoOoOoOoMjOoOoOoOoOoOoMcMdMeEa
PpOoOoOoOoMkOoOoOoOoOoOoOoEmFpEnOoOoOoOoOoMjOoOoOoOoOoOoMfOoMbEc
AaAaAaAaAaAgAaAfOoOoOoOoOoOoOoOoOoOoOoOoOoMjOoOoAeAaAaAaBhAaBdAm
DfDgBoDeDfKpDhDeOoOoOoOoOoOoOoOoOoOoOoOoOoMjOoOoDfDhBoDeDfDhDgDc
PpOoBpOoOoMjOoOoOoOoOoOoOoFaFbFcOoOoOoOoOoMjOoOoOoOoBpOoOoOoOoEc
PpOoBpOoOoMjOoOoOoOoOoOoOoGaOoGcOoOoOoOoOoMkOoOoOoOoBpOoOoOoOoEa
PpOoBpOoOoMkOoOoAeAaAaAaAaBjAaBkAaAaAaAaAaAgAaAfOoOoBpOoOoOoOoEc
PpOoBpOoOoMjOoOoDfDgBoDeDfKpKoKoKoKoKoKoKoKpDhDeOoOoBpOoOoOoOoEc
PpOoBpOoOoMjOoOoOoOoBpOoOoOoOoOoOoOoOoOoOoOoOoOoOoOoBpOoOoOoOoEa
PpOoBpOoOoMkOoOoOoOoBpOoOoOoOoOoOoOoOoOoOoOoOoOoOoOoBpOoOoOoOoEc
AaAaAbAaAaAgAaAfOoOoBpOoOoOoOoOoOoOoOoOoOoOoOoOoAeAaAbAaAaAaAaAm
KoKoKoKoKoKpDhDeOoOoBpOoOoOoOoOoOoOoOoOoOoOoOoOoDfDhDgDeDfBoDgDc
PpOoOoOoOoOoOoOoOoOoBpOoOoOoOoOoOoOoOoOoOoOoOoOoOoOoOoOoOoBpOoEc
PpOoOoOoOoOoOoOoOoOoBpOoOoOoOoOoJdJpJeOoOoOoOoOoOoOoOoOoOoBpOoEa
PpOoOoOoOoOoOoOoOoOoBpOoOoOoOoOoKdJoKeOoOoOoOoOoOoOoOoOoOoBpOoEc
PpOoOoOoOoOoOoOoOoOoBpOoOoOoOoOoJbPdJaOoOoOoOoOoOoOoOoOoOoBpOoEc
AaAaAaAaAaAaAaAaAaAaAbAaAaAaAaAaApAaAoAaAaAaAaAaAaAaAaAaAaAbAaAm
CgCfCgCfCgCfCgCfCgCfCgCfCgCfCgCfCgCfCgCfCgCfCgCfCgCfCgCfCgCfCgCf
HmGmHmGmHmGmHmGmHmGmHmGmHmGmHmGmHmGmHmGmHmGmHmGmHmGmHmGmHmGmHmGm
OdOdOdOdOdOdOdOdOdOdOdOdOdOdOdOdOdOdOdOdOdOdOdOdOdOcOeOfOfOfOdOd
OoOoOoOoOoOoOoOoOoOoOoOoOoOoOoOoOoOoOoOoOoOoOoOoOoOoOoNpNpNpOoOo
OoOoOoOoOoOoOoOoOoOoOoOoOoOoOoOoOoOoOoOoOoOoOoOoOoOoOoOoOoOoOoOo