TILEMAP
42 26 							-- Size of tile map in tiles
16 16 							-- Tile size & block size
images/TheGoonies-MapTiles2-3.png 	-- Tilesheet
16 16								-- Number of tiles in tilesheet
OoOoOoOoOoOoOoOoOoOoOoOoOoOoOoOoOoOoOoOoOoOoOoOoOoOoOoOoOoOoOoOoOoOoOoOoOoOoOoOoOoOo
OoOoOoOoOoOoNcNdNkOoOoOoOoOoOoOoNiNdNhOoOoOoOoOoOoOoOoOoOoOoOoNgNaNbNeNbOoOoOoOoOoOo
OoOoOoOoOoOoNlNfNkOoOoOoOoOoOoOoNbNjNfOoOoOoOoOoOoOoOoOoOoOoOoNmOoNkNmOoOoOoOoOoOoOo
OoOoOoOoOoEgEhEgEhEgEhEgEhDdDgDhDeDfDgDhDeDfDhDgDeDfDhDgDcEgEhEgEhOoPoOoEcOoOoOoOoOo
OoOoOoOoOoEhEgEhEgEhEgEhEgEdOoOoOoOoOoOoOoOoOoOoOoOoOoOoEcEhEgEhEgOoBpOoEcOoOoOoOoOo
OoOoOoOoOoEgEhEgEhEgEhEgEhEbOoOoOoOoOoOoOoOoOoOoOoOoOoOoEaEgEhEgEhOoBpOoEcOoOoOoOoOo
OoOoOoOoOoEhEgEhEgEhEgEhEgAnAaAaAaAaAaAaAfOoOoOoOoOoOoOoEcEhEgEhEgOoBpOoEcOoOoOoOoOo
OoOoOoOoOoDdDgDhDeDfDgDhDeDfDhDgDeDfBoDgDeOoOoOoOoJfJgJhEcEgEhEgEhOoBpOoEcOoOoOoOoOo
OoOoOoOoOoEdOoOoOoOoOoOoOoOoOoOoOoOoBpOoOoOoOoOoOoMcMdMeEcEhEgEhEgOoBpOoEcOoOoOoOoOo
OoOoOoOoOoEbOoOoOoOoOoOoOoOoOoOoOoOoBpOoOoOoOoOoOoMfOoMbEaEgEhEgEhOoBpOoEcOoOoOoOoOo
OoOoOoOoOoAnAaAaAaAaAaAaAaAaAaAaAaAaAbAaAaAaAaAaAaBhAaBdAmEhEgEhEgOoBpOoEcOoOoOoOoOo
OoOoOoOoOoEgEhEgEhEgEhEgEhDcDgBoDeDfDgDhDeDfDgDhDeDfDgDhDeDfDgDhDdOoBpOoEcOoOoOoOoOo
OoOoOoOoOoEhEgEhEgEhEgEhEgEdOoBpOoOoOoOoOoOoOoOoOoOoOoOoOoOoOoOoOoOoBpOoEcOoOoOoOoOo
OoOoOoOoOoEgEhEgEhEgEhEgEhEbOoBpOoOoOoOoOoOoOoOoOoOoOoOoOoOoOoOoOoOoBpOoEcOoOoOoOoOo
OoOoOoOoOoEgEhEgEhEgEhEgEhEbOoBpOoOoOoOoOoAeAaAaAaAaAaAaAaAaAaAaAaAaAbAaAmOoOoOoOoOo
OoOoOoOoOoDdDgDhDeDfDgDhDeOoOoBpOoOoOoOoOoDfDhDgDeDfDhDgDcEgEhEgEhEgEhEgEhOoOoOoOoOo
OoOoOoOoOoEdOoOoOoOoOoOoOoOoOoBpOoOoOoOoOoOoOoOoOoOoOoOoEcEhEgEhEgEhEgEhEgOoOoOoOoOo
OoOoOoOoOoEbOoOoOoOoOoOoOoOoOoBpOoOoOoOoOoOoOoOoOoOoOoOoEaEgEhEgEhEgEhEgEhOoOoOoOoOo
OoOoOoOoOoAnAaAaAaAaAaAaAaAaAaAbAaAaAaAaAfOoOoOoOoOoOoOoEcEhEgEhEgEhEgEhEgOoOoOoOoOo
OoOoOoOoOoDdDhDgDeDfBoDgDeDfDhDgDeDfBoDgDeOoOoOoOoOoOoOoOoDfDgDhDeDfDgDhDcOoOoOoOoOo
OoOoOoOoOoEdOoOoOoOoBpOoOoOoOoOoOoOoBpOoOoOoOoFaFbFcOoOoOoOoOoOoOoOoOoOoEcOoOoOoOoOo
OoOoOoOoOoEbOoOoOoOoBpOoOoOoOoOoOoOoBpOoOoOoOoGaOoGcOoOoOoOoOoOoOoOoOoOoEcOoOoOoOoOo
OoOoOoOoOoAnAaAaAaAaAbAaAaAaAaAaAaAaAbAaAaAaAaBjAaBkAaAaAaAaAaAaAaAaAaAaAmOoOoOoOoOo
OoOoOoOoOoOdOdOdOdOdOdOdOdOdOdOdOdOdOdOdOdOdOdOdOdOdOdOdOdOdOcOeOfOfOfOdOdOoOoOoOoOo
OoOoOoOoOoOoOoOoOoOoOoOoOoOoOoOoOoOoOoOoOoOoOoOoOoOoOoOoOoOoOoOoNpNpNpOoOoOoOoOoOoOo
OoOoOoOoOoOoOoOoOoOoOoOoOoOoOoOoOoOoOoOoOoOoOoOoOoOoOoOoOoOoOoOoOoOoOoOoOoOoOoOoOoOo
