TILEMAP
32 26 							-- Size of tile map in tiles
16 16 							-- Tile size & block size
images/TheGoonies-MapTiles2.png 	-- Tilesheet
16 16								-- Number of tiles in tilesheet
OoOoOoOoOoOoOoOoOoOoOoOoOoOoOoOoOoOoOoOoOoOoOoOoOoOoOoOoOoOoOoOo
OoNcNdNkOoOoOoOoOoOoOoNiNdNhOoOoOoOoOoOoOoOoOoOoOoOoNgNaNbNeNbOo
OoNlNfNkOoOoOoOoOoOoOoNbNjNfOoOoOoOoOoOoOoOoOoOoOoOoNmOoNkNmOoOo
EgEhEgEhEgEhEgEhEgEhEgEhEgEhEgEhEgEhEgEhEgEhEgEhEgEhEgEhEgEhEgEh
EhEgEhEgEhEgEhEgEhEgEhEgEhEgEhEgEhEgEhEgEhEgEhEgEhEgEhEgEhEgEhEg
EgEhEgEhEgEhEgEhEgEhEgEhEgEhEgEhEgEhEgEhEgEhEgEhEgEhEgEhEgEhEgEh
EhEgEhEgEhEgEhEgEhEgEhEgEhEgEhEgEhEgEhEgEhEgEhEgEhEgEhEgEhEgEhEg
DdDgDhDeDfDgDhDeDfDgDhDeDfDgDhDeDfDhDgDeDfDhDgDcDdDgDhDeDfDgDhDe
EdOoOoOoOoOoOoOoOoOoOoOoOoOoOoEeEfOoOoOoOoOoOoEcEdOoOoOoOoOoOoNn
EbOoOoOoOoOoOoOoOoOoOoOoHbCmGkOoOoOoOoOoOoOoOoEaEbOoOoOoOoOoOoNn
EdOoOoOoOoOoOoOoFaFbFcOoMaOoHkOoOoOoOoOoOoOoOoEcEdOoOoOoOoOoOoNn
EdOoOoOoOoOoOoOoGaOoGcOoHeOoHcOoOoOoOoOoOoOoOoOoOoOoOoOoOoOoOoNn
EbOoOoAeAaAaAaAaBjAaBkAaCaAaCbAaAaAaAaAaAfOoOoOoOoOoOoAeAaAaAaAa
DbOoOoDgFhBoDhDeDfDhDgDeDfDhDgDeDfDhBoFhDgOoOoOoOoOoOoDgFhBoDhDc
EdOoOoOoOoBpOoEeEfOoOoOoOoOoOoOoOoOoBpOoOoOoOoOoOoOoOoOoOoBpOoEa
EdOoOoOoOoBpOoOoOoOoOoOoOoOoOoOoOoOoBpOoOoOoOoJfJgJhOoOoOoBpOoEc
EbOoOoOoOoBpOoOoOoOoFaFbFcOoOoOoOoOoBpOoOoOoOoMcMdMeOoOoOoBpOoEa
EdOoOoOoOoBpOoOoOoOoGaOoGcOoOoOoOoOoBpOoOoOoOoMfOoMbOoOoOoBpOoEc
AnAaAaAaAaAbAaAaAaAaBjAaBkAaAaAaAaAaAbAaAaAaAaBhAaBdAaAaAaAbAaAm
EgEhEgEhEgEhEgEhEgEhEgEhEgEhEgEhEgEhEgEhEgEhEgEhEgEhEgEhEgEhEgEh
EhEgEhEgEhEgEhEgEhEgEhEgEhEgEhEgEhEgEhEgEhEgEhEgEhEgEhEgEhEgEhEg
EgEhEgEhEgEhEgEhEgEhEgEhEgEhEgEhEgEhEgEhEgEhEgEhEgEhEgEhEgEhEgEh
EhEgEhEgEhEgEhEgEhEgEhEgEhEgEhEgEhEgEhEgEhEgEhEgEhEgEhEgEhEgEhEg
OdOdOdOdOdOdOdOdOdOdOdOdOdOdOdOdOdOdOdOdOdOdOdOdOdOcOeOfOfOfOdOd
OoOoOoOoOoOoOoOoOoOoOoOoOoOoOoOoOoOoOoOoOoOoOoOoOoOoOoNpNpNpOoOo
OoOoOoOoOoOoOoOoOoOoOoOoOoOoOoOoOoOoOoOoOoOoOoOoOoOoOoOoOoOoOoOo
